49
************--
************--
****....****--
****....****--
**..........--
**..........--
--------------
--------------
^^^^........^^
^^^^........^^
^^^^....^^^^^^
^^^^....^^^^^^
^^^^^^^^^^^^^^
^^^^^^^^^^^^^^