64
^^**--**^^^^--^^
^^**--**^^^^--^^
^^**--**^^^^--^^
^^**--**^^^^--^^
^^**--**^^^^--^^
^^**--**^^^^--^^
^^**--**^^^^--^^
^^**--**^^^^--^^
^^^^--**^^^^--^^
^^^^--**^^^^--^^
^^^^----------^^
^^^^----------^^
^^^^........**^^
^^^^........**^^
^^^^....******^^
^^^^....******^^
