81
..****^^^^^^^^^^^^
..****^^^^^^^^^^^^
..****^^^^^^^^****
..****^^^^^^^^****
....**^^^^^^^^****
....**^^^^^^^^****
....**^^^^********
....**^^^^********
------------------
------------------
....**^^^^********
....**^^^^********
....**^^^^^^^^****
..****^^^^^^^^****
..****^^^^^^^^^^^^
..****^^^^^^^^^^^^
****^^^^^^^^^^^^^^
****^^^^^^^^^^^^^^