25
2211222244
2211222244
2211334444
2211334444
3311334444
3311333344
3311332244
3311222222
4411222222
4411222222