25 
****--****
****--****
**..--..**
**..--..**
....--..**
....--..^^
....--..^^
....--..^^
^^^^--^^^^
^^^^--^^^^