36
--..****....
--..****....
--**^^^^^^**
--**^^^^^^**
--..^^^^^^**
--..^^^^^^**
--..**^^**..
--..**^^**..
--....^^....
--....^^....
------------
------------